bfpd
.........bbb
.bb....fffff
.fff........
.b.b.b....bb
.....f....ff
.....b......
....ff......
.b..........
.ff...bb....
......ff....
...........b
....ff...fff
.bb.........
.ff..b...bbb
.....f....bb
bbb........b
fff.........
.....ff.....
..........bb
..........ff
........b...
.......fff..
........p...
dddddddddddd