bfpd
......bbbb..
bb....fffbbb
ff.......bbb
.....f...bbb
...f....bbbb
........bbbb
f........bbb
.........bbb
...f......bb
..........bb
f..........b
...........b
...f........
............
f...........
............
...f........
............
f...........
............
...f...f....
............
p.........ff
dddddddddddd
