bfpd
......bbbb..
....ffffff..
..bb........
..fff..ff...
............
.....b....ff
.....fffb.b.
b........b.b
f.........b.
..b........b
..ff.......f
............
.bb.f.......
ffff......b.
........fff.
bb..b...b...
ff..ff.....b
..........ff
......bbb...
......fff...
bbb.........
ffff........
........p...
dddddddddddd