bfpd
..bbb.......
..ffff......
b.b....b....
ff....ff....
....b.b.....
....ff......
..b.b.......
..fff.......
b.b.....b...
fff....ff...
....b.......
...ff.......
............
..ffff......
............
ffff........
........b...
..ffff..ff..
....b.......
....fff.....
............
ffff..ffff..
p...........
dddddddddddd
