bfpd
..bbb.......
..fff.......
.........bbb
........ffff
..bb........
..fff..ff...
..b.......b.
bb........f.
bb..........
ff...fff....
..b.......bb
....b.....ff
.b....ff....
.ff.....bb..
........ff..
....bbb.....
.b...ff.....
ff........bb
...b.b....ff
...fff......
.b..........
.ff.........
p...........
dddddddddddd