bfpd
..bbbb......
..ffff......
b.b....b....
ff....ff....
....b.b.....
....ff......
..b.b.......
...f........
b.b.....b...
..f.........
....b.......
....f.......
............
...f........
............
f...........
............
..f.........
............
....fff.....
............
ffff..ffff..
p...........
dddddddddddd
